3 3 3 3 3 3 3 3 3 3
3 3 3 3 3 3 3 3 3 3
3 3 3 3 3 3 3 2 3 3
3 3 3 3 3 3 2 2 2 3
3 3 3 3 3 2 2 2 12 12
3 3 3 3 3 12 12 12 12 12
3 3 3 3 12 12 12 12 12 12
3 3 3 12 12 9 9 9 9 9
3 3 12 12 9 9 9 9 9 9
3 12 12 9 9 9 9 9 9 9

3 3 3 3 3 3 3 3 3 3
3 3 3 3 3 3 3 2 3 3
3 3 3 3 3 2 2 0 2 2
3 3 3 3 3 2 0 0 0 2
3 3 3 2 2 0 0 0 0 0
3 3 3 2 2 0 0 0 0 0
3 3 2 2 0 0 0 0 0 0
3 2 2 0 0 0 0 0 0 0
3 2 0 0 0 0 0 0 0 0
2 0 0 0 0 0 0 0 0 0

2 2 2 2 2 2 2 2 2 2
2 2 2 2 2 2 2 0 2 2
2 2 2 2 2 0 0 0 0 0
2 2 2 2 2 0 0 0 0 0
2 2 2 2 0 0 0 0 0 0
2 2 2 0 0 0 0 0 0 0
2 2 0 0 0 0 0 0 0 0
2 0 0 0 0 0 0 0 0 0
2 0 0 0 0 0 0 0 0 0
0 0 0 0 0 0 0 0 0 0

0 0 0 0 0 0 0 0 0 0
0 0 0 0 0 0 0 0 0 0
0 0 17 58 0 0 0 0 0 0
0 0 0 0 0 0 0 0 0 0
0 0 0 0 0 0 0 0 0 0
0 0 0 0 0 0 0 0 0 0
0 0 0 0 0 0 0 0 0 0
0 0 0 0 0 0 0 0 0 0
0 0 0 0 0 0 0 0 0 0
0 0 0 0 0 0 0 0 0 0

0 0 0 0 0 0 0 0 0 0
0 0 0 0 0 0 0 0 0 0
0 0 17 0 0 0 0 0 0 0
0 0 0 0 0 0 0 0 0 0
0 0 0 0 0 0 0 0 0 0
0 0 0 0 0 0 0 0 0 0
0 0 0 0 0 0 0 0 0 0
0 0 0 0 0 0 0 0 0 0
0 0 0 0 0 0 0 0 0 0
0 0 0 0 0 0 0 0 0 0

0 0 0 0 0 0 0 0 0 0
0 0 0 0 0 0 0 0 0 0
0 0 17 0 0 0 0 0 0 0
0 0 0 0 0 0 0 0 0 0
0 0 0 0 0 0 0 0 0 0
0 0 0 0 0 0 0 0 0 0
0 0 0 0 0 0 0 0 0 0
0 0 0 0 0 0 0 0 0 0
0 0 0 0 0 0 0 0 0 0
0 0 0 0 0 0 0 0 0 0

18 18 18 18 18 0 0 0 0 0
18 18 18 18 18 0 0 0 0 0
18 18 17 18 18 0 0 0 0 0
18 18 18 18 18 0 0 0 0 0
18 18 18 18 18 0 0 0 0 0
0 0 0 0 0 0 0 0 0 0
0 0 0 0 0 0 0 0 0 0
0 0 0 0 0 0 0 0 0 0
0 0 0 0 0 0 0 0 0 0
0 0 0 0 0 0 0 0 0 0

18 18 18 18 18 0 0 0 0 0
18 18 18 18 18 0 0 0 0 0
18 18 17 18 18 0 0 0 0 0
18 18 18 18 18 0 0 0 0 0
18 18 18 18 0 0 0 0 0 0
0 0 0 0 0 0 0 0 0 0
0 0 0 0 0 0 0 0 0 0
0 0 0 0 0 0 0 0 0 0
0 0 0 0 0 0 0 0 0 0
0 0 0 0 0 0 0 0 0 0

0 0 0 0 0 0 0 0 0 0
0 0 18 0 0 0 0 0 0 0
0 18 18 18 0 0 0 0 0 0
0 0 18 0 0 0 0 0 0 0
0 0 0 0 0 0 0 0 0 0
0 0 0 0 0 0 0 0 0 0
0 0 0 0 0 0 0 0 0 0
0 0 0 0 0 0 0 0 0 0
0 0 0 0 0 0 0 0 0 0
0 0 0 0 0 0 0 0 0 0

0 0 0 0 0 0 0 0 0 0
0 0 18 0 0 0 0 0 0 0
0 18 18 18 0 0 0 0 0 0
0 0 18 0 0 0 0 0 0 0
0 0 0 0 0 0 0 0 0 0
0 0 0 0 0 0 0 0 0 0
0 0 0 0 0 0 0 0 0 0
0 0 0 0 0 0 0 0 0 0
0 0 0 0 0 0 0 0 0 0
0 0 0 0 0 0 0 0 0 0
